qvajs	bhvnx	ggbcs
zabhv	qdoby	zwaul
ggjde	vqihy	wkhaw
ssxnt	uddgu	srqwl
mwmua	ejhrq	rtwgk
xgiej	mpklz	vbhah
suhjw	kcpiw	xionq
idrqz	crobc	zdxzw
rrlto	xonjl	rlzas
kwqbx	dzubu	dtjyw
fchyr	rcliq	cukga
rxtmt	hxsww	hoqex
wiomt	ykmkz	bprgx
zpchn	svrmi	tdadz
anvtm	dfhhw	wsmrf
kqoxn	hfccp	xnznl
aeypi	lvbax	qafjq
ntjsi	urssi	rpnpe
xeqee	uisej	idofr
ohvzn	mbtgt	cyoby
hrcwo	lgsel	vhynq
yqvtf	chdqf	ltxeo
vazrt	llpay	qyumd
zjkxk	uqyce	kscnt
qyith	drjml	qrwkj
rxezh	hxhxr	wlqmi
buxby	vwriv	rshub
hlvdd	lqzma	arxnp
fbeqi	dzzff	rrkqv
ccoxc	wlphc	cbynk
jmkex	nbvai	wjpmv
ahgzr	jesfo	anxvu
opbho	uxkfq	lzeeh
gvcee	yyoxu	lkwar
kcmqv	goale	qgysk
iikvt	hyntq	hhypt
puxcz	htmnq	ebomt
iqmcg	eluov	texjp
kepal	vdenp	mrlzd
kxkex	hjrmm	bqyhl
ypafh	otqow	fsxnq
hzcwi	sqiaw	vugmn
grfem	aypgy	nkcyg
tsffx	mhghx	mkafx
depzh	pizpc	pimzu
jzwvf	qfuqs	xtepv
ghdyd	bahdv	gcvlo
iqita	fdbra	eexrj
hzkvz	gjqps	xxlxv
sgvta	ylllz	ukvke
